5 5 
#####
#___#
#_%_#
#___#
#####