9 9  
#########
#___#####
#_O_###x#
#_O_###x#
###_###x#
###_____#
##_O_#__#
##%__####
#########